00000000000000000000
00040000000000004000
00000000000000000000
11111111111111111111
21111111111111111113
00000000000000000000
00040000000000004000
00000000000000000000