00000000000000000000
00040000000000004000
00000000000000000000
00000000000000000000
21111111111111111113
00000000000000000000
00040000000000004000
00000000000000000000