00000000000000000020
00000000000000000010
00000000000000000010
00011111100000000010
00010000100000000010
00010000100004000010
00010400100000000010
00010000111111111110
00010000000000000000
00010000000000000000
00010000000000000000
00010000000000000000
00010000000000000000
00010400000000000000
00010000000000000000
00010000000000000000
00010000000000000000
00010000000000000000
00010000000000000000
00010000000000111113
00010000000000100000
00010000000000100000
00010000000000100400
00010000000000100000
00010400000000100000
00010000000000100000
00010000000000100000
00010000000000100000
00011111100000100000
00000000100000100000
00000400100000100000
00000000100000100000
00000000100000100000
00000000100000100000
00000000100000100000
00000000100000100000
00000000100400100000
00000000100000100000
00000000100000100000
00000000100000100000
00000000100000100000
00000000100000100000
00000000100400100000
00000000100000100000
00000000100000100000
00000000111111100000
00000000000000000000
00000000000000000000
00000000000000000000
00000000000000000000